7
W W W W W W W
W S T T T S W
W T W T T T W
W T T W T T W
W T T T W T W
W S T T T S W
W W W W W W W